-------------------
-------EEEEE-------
-----E.......E-----
---E...........E---
---E...........E---
--E.............E--
--E.............E--
-E...............E-
-E...............E-
-E...............E-
-E...............E-
-E...............E-
--E.............E--
--E.............E--
---E...........E---
---E...........E---
-----E.......E-----
-------EEEEE-------
-------------------